#####################
#####################
#####################
##.........##.......#
##.#######.##.###.###
##.#######....###...#
##.#######.##.###.#.#
##....####.##.....#.#
###.######.######.#.#
###.####...########.#
###.#....#.#####....#
##..#.##.#.....#.####
##.#..##.#####.#...@#
##.#...#.#####.#.####
$...##.#.#####.###..#
##.###.#.#####.....##
##.....#.#####.##.###
########.########.###
#####################
#####################